2 1 1 1 1 1 2 1 2 1 2 
2 2 2 1 2 2 2 1 2 2 1 
1 1 1 2 8 7 1 9 9 2 3 
9 8 2 2 9 8 9 2 6 7 3 
9 7 1 6 2 2 2 6 8 6 4 
6 6 9 1 1 8 9 1 7 8 5 
2 6 1 1 6 2 1 6 6 6 4 
1 2 1 1 7 6 6 2 1 2 1 
7 8 2 8 7 9 1 6 7 9 2 
2 2 8 1 8 2 8 6 9 6 3 
